11111111111
100100000C1
10000111001
1P0011E0001
11111110111
11111110111
10010000001
10000111101
10001100001
11111111111