11111111111111111111111111111111111
1000100001000101C001001010100101001
1000100100000001C001000010000001001
1000110111111111000101111010C001011
101110C0001000011011001010111011001
10001C01001001C10000001010100001001
11101101111011110111101010111101011
10001000001000010001000000100001001
11101001000001011101111111111111101
10001011011011110000100100100001001
1E000000001001010000100100100101001
1110111011100001111C001100100100001
10001000001001010010100001111101011
10111111111111000000100100000001001
10000000000000011010101111111011011
11111111111111010010100000000001001
1000010001001001111P111011111111001
10010000000010010000100000010001101
10010100010000010010100001000001001
11111111111111111111111111111111111
