11111111111111111111
1E00000010000C1C0011
11111110101010111011
10000010101010100011
10111010111010101111
10001010100010100011
10101010101110111011
10101010001000100011
11101011111011101111
10001010001000100011
10111010111110111011
10100000100010100011
10111111101010101011
10000000101010101011
101111101C1010101011
1010100P101010101011
10101011101010101011
100C1000001000001011
11111111111111111111
11111111111111111111
