11111111111111111111
10001000100000100101
10001000101C00000001
11011011101111101111
10000000001000P01001
10001111101000101001
10111001001111101011
10001000001000101001
11101011011000001001
10001001001000100001
11111111111011111111
10000010010000000001
1001C000010101001001
1101101000C101111101
1001001C0101C1000101
10011111110100E00001
10010000000101110101
10110001000101000101
10010001000101000101
11111111111111111111
